###############
#_____b_______#
#____bbb______#
#___bbbbb_____#
#__bbbbbbb____#
#___bbbbb_____#
#____bbb______#
#_____b_______#
###############
