.................---..............
WWWWW.WWWWW.WWWWW---WWWWW.........
WwwwW.WwwwW.WwwwW---WwwwW.........
WwwwW.WwwwW.WwwwW---wwwwW.........
WwwwW.WwwwW.WwwwW---WwwwW.........
WWwWW.WWwWW.WWwWW---WWWWW.........
--------------------..............
-------------------...............
------------------................
WWwWW.WWwWW.WWwWW.................
WwwwW.WwwwW.WwwwW.................
WwwwW.WwwwW.WwwwW.................
WwwwW.WwwwW.WwwwW.................
WWWWW.WWWWW.WWWWW.................
