#################
#################
##z_z##z##z_z##z#
_######_#######_#
#######z#######z#
##z#######z######
##_#######_######
##z##z_z##z##z_z#
#################
#################
##z_z##z##z_z##z#
#######_#######_#
#######z#######z#
##z#######z######
##_#######_######
##z##z_z##z##z_z#
#################
#################
#################
#################
#################
