##########_#########
#__________________#
#__________________#
#__________________#
#__________________#
#____#####_________#
#____#___#_________#
#____#___#_________#
#____#___#_________#
#____#___#_________#
#____##_##_________#
#__________________#
#__________________#
#__________________#
#__________________#
#__________________#
#__________________#
#__________________#
#__________________#
##########_#########
