#############
#____#_______
#____#_______
#____#_______
#____________
#____#_______
#____#_______
#____#_______
######_______
