55555555555555555555555555555555
55555555555555555555555555555555
55555555555555555555555555555555
55555555555555555555555555555555
55555555555555555555555555555555
55555555555555555555555555555555
55555555555555555555555555555555
55555555555555555555555555555555
55555555555555555555555555555555
55555555555555555555555555595555
55555555555555555555555555999555
55555555555555555666665555999555
55555555555555555577755555595555
55555555555555555558555555999555
55555555555555555559555555999555
55555555555555555559555955999555
55555599999959999999955555999555
55599999999959999999955555999555
55599999999999999999999999999555
55599999999999999999999999999555
55599999999999999999999999999555
55599999999959999999955555555555
55555599999959999999955555555555
55555555555555599955555555555555
55555555555555599955555555555555
55555555555555599955555555555555
55555555555555588855555555555555
55555555555555777775555555555555
55555555555556666666555555555555
55555555555555555555555555555555
55555555555555555555555555555555
55555555555555555555555555555555
55555555555555555555555555555555
55555555555555555555555555555555
55555555555555555555555555555555
55555555555555555555555555555555
