###############
###############
######___######
######___######
...zzzzzzzzz...
....zzzzzzz....
.....zzzzz.....
...............
...............
...............
